2 2 2 2 2 2 2 2 2 2 2 2 2 2 2 2 2 2 2 2 2 2 2 2 2 2 2 2 2 2 2 2 2 2 2 2 2 2 2 2 2 2 2 2 2 2 2 2 2 2 
2 2 0 2 2 2 2 0 2 2 2 2 2 2 2 0 2 2 2 2 2 0 2 2 2 2 2 0 2 2 2 2 2 2 2 2 0 2 2 2 2 2 0 2 2 2 2 0 2 2 
2 2 2 2 2 2 2 2 2 2 2 2 2 2 2 2 2 2 2 2 2 2 2 2 2 2 2 2 2 2 2 2 2 0 2 2 2 2 2 2 2 2 2 2 2 2 2 0 2 2 
2 2 2 2 2 2 2 2 2 2 2 2 2 2 2 2 2 2 2 2 2 2 2 2 2 2 2 2 2 2 2 2 2 2 2 2 2 2 2 2 2 2 2 2 2 2 2 2 2 2 
2 2 2 2 2 0 2 2 2 2 2 2 0 2 2 2 2 2 2 2 2 2 2 2 2 2 2 2 2 0 2 2 2 2 2 2 2 2 0 2 2 0 2 2 2 2 2 2 2 2 
2 2 2 2 2 2 2 2 2 2 2 2 2 2 2 2 2 2 0 2 2 2 2 2 0 2 2 2 2 2 2 2 2 2 0 2 2 2 2 2 2 0 2 2 2 2 0 2 2 2 
2 2 0 2 2 2 2 2 2 2 2 2 2 2 2 2 2 2 2 2 2 2 2 2 2 2 2 2 2 2 2 2 2 2 2 2 2 2 2 2 2 2 2 2 0 2 2 2 2 2 
2 2 2 2 2 0 2 2 2 0 2 2 2 2 0 2 2 2 2 2 2 2 0 2 2 2 2 0 2 2 2 0 2 0 2 2 2 2 2 0 2 2 2 2 2 2 2 2 2 2 
2 2 2 2 2 2 2 0 2 2 2 2 2 2 2 2 2 2 2 2 2 2 2 2 2 2 2 2 2 2 2 2 2 2 2 2 2 2 2 2 2 2 2 2 2 2 2 2 2 2 
2 2 2 2 2 2 2 2 2 2 2 2 2 2 8 8 5 8 7 8 8 2 2 2 2 2 1 1 1 1 1 1 6 4 6 6 2 2 2 2 2 2 2 2 2 2 0 2 2 2 
2 2 2 2 2 0 2 2 2 2 2 2 5 8 7 6 7 8 8 9 8 8 5 0 2 2 1 1 1 1 1 1 1 4 4 4 4 2 2 2 2 2 0 2 2 2 2 0 2 2 
2 2 0 2 2 2 2 2 2 2 9 8 8 6 8 4 8 8 8 8 7 8 8 8 8 8 8 8 1 1 1 1 1 1 4 4 4 4 2 2 2 2 2 2 2 2 2 2 2 2 
2 2 2 2 2 2 0 2 2 2 8 7 8 4 8 4 9 8 7 8 8 8 7 8 9 7 8 8 8 1 1 1 1 1 6 6 4 4 9 2 2 2 2 2 2 2 2 2 2 2 
2 2 2 2 2 2 2 2 2 2 8 6 4 4 4 4 6 8 5 8 8 5 8 8 8 8 8 5 7 8 1 1 1 1 6 4 4 4 6 1 2 2 2 2 2 2 2 2 0 2 
2 2 2 2 0 2 2 2 2 2 7 8 7 4 4 8 8 7 8 8 8 4 8 7 8 8 4 8 8 4 8 1 1 5 4 4 4 6 1 1 2 2 2 2 0 2 2 2 2 2 
2 2 2 2 2 2 2 2 0 2 6 4 4 4 4 4 6 8 4 8 9 8 8 8 8 8 7 8 8 9 8 7 8 8 8 8 8 1 1 1 2 2 0 2 2 2 2 2 2 2 
2 0 2 2 2 2 0 2 2 2 8 8 6 4 7 8 8 8 8 7 8 8 8 4 8 8 8 8 8 8 8 4 8 7 8 8 1 1 1 1 2 2 2 2 2 2 0 2 2 2 
2 2 2 2 2 2 2 2 2 2 2 7 5 8 4 8 8 8 8 8 4 8 8 8 8 7 8 8 4 8 8 8 8 8 4 8 7 8 1 1 2 2 0 2 2 2 2 2 0 2 
2 2 2 2 2 0 2 2 2 2 0 8 7 8 8 8 4 5 9 8 8 8 8 7 8 8 8 8 8 8 8 7 8 8 8 8 8 8 1 1 2 2 2 2 2 2 2 2 2 2 
2 2 0 2 2 2 2 2 0 2 2 8 8 8 8 8 7 1 8 8 8 8 2 2 2 2 0 5 8 7 8 8 8 8 8 8 8 7 8 1 2 2 2 2 2 2 2 2 2 2 
2 2 2 2 2 2 2 2 2 2 7 8 8 8 4 1 1 1 8 7 8 2 0 2 6 2 2 2 2 8 8 5 8 8 8 4 8 8 8 7 2 2 2 2 0 2 2 2 2 2 
2 2 2 2 2 2 2 0 2 2 1 8 4 8 7 1 1 5 8 8 2 2 2 8 8 7 2 0 2 2 7 8 4 8 8 8 8 8 8 8 2 2 2 2 2 2 2 2 2 2 
2 0 2 2 2 2 2 2 2 2 1 7 8 8 9 1 7 8 8 8 2 2 2 8 8 8 2 2 2 9 8 8 8 8 8 8 7 8 8 8 0 2 2 2 2 2 2 2 2 2 
2 2 2 2 2 0 2 2 2 2 1 1 8 8 8 5 8 8 8 8 8 2 0 2 7 2 0 2 7 8 8 8 8 8 4 8 8 6 6 6 2 2 2 2 0 2 2 2 2 2 
2 2 2 2 2 2 2 2 2 2 1 1 1 7 8 8 8 8 8 5 7 8 2 2 8 2 2 8 8 8 7 8 8 8 5 8 4 6 4 6 2 2 2 2 2 2 2 0 2 2 
2 2 2 2 2 2 0 2 2 2 1 1 1 1 4 8 8 8 7 8 8 8 8 8 8 8 8 8 8 8 8 8 7 5 5 7 8 4 4 6 2 2 2 2 2 2 2 2 2 2 
2 2 2 0 2 2 2 2 2 2 6 6 6 8 7 8 8 8 8 8 8 8 8 7 8 8 8 7 8 8 8 8 9 8 4 8 4 6 4 6 2 2 2 2 2 2 2 2 2 2 
2 2 2 2 2 2 2 2 0 2 6 4 4 8 8 8 7 8 8 8 8 7 2 2 2 8 2 2 5 8 8 7 8 8 8 8 4 6 4 6 2 2 0 2 2 2 2 2 2 2 
2 2 2 2 2 2 2 2 2 2 6 4 4 8 4 8 8 8 4 8 9 2 0 2 8 8 2 0 2 7 8 8 8 8 5 8 7 4 4 6 2 2 2 2 2 2 0 2 2 2 
2 2 0 2 2 2 0 2 2 2 6 4 4 8 7 4 8 8 8 7 8 2 2 6 8 8 2 2 2 8 8 8 8 7 9 4 8 6 4 6 2 2 2 2 2 2 2 2 2 2 
2 2 2 2 2 2 2 2 2 2 6 4 4 8 8 8 8 4 8 8 8 2 2 2 8 7 0 2 7 8 8 5 8 4 8 8 8 6 4 6 2 2 2 0 2 2 2 2 2 2 
2 2 2 2 2 0 2 2 2 2 6 6 6 8 8 4 8 8 8 8 8 8 5 0 2 2 2 8 8 8 7 8 8 8 8 7 4 4 4 6 2 2 2 2 2 2 2 2 2 0 
2 2 2 2 2 2 2 2 2 2 2 2 2 8 7 8 8 8 5 8 7 8 8 8 8 8 8 8 8 9 8 4 8 7 8 8 8 6 4 6 2 2 2 2 2 2 2 2 2 2 
2 2 0 2 2 2 2 2 2 0 2 2 2 2 8 8 8 7 8 8 8 8 8 8 4 7 8 8 4 8 8 8 8 4 8 4 8 6 6 6 2 0 2 2 2 0 2 2 2 2 
2 2 2 2 2 2 2 2 2 2 2 0 9 8 8 4 8 8 4 8 8 8 4 8 8 8 4 8 8 8 4 8 7 8 8 8 8 1 1 1 2 2 2 2 2 2 2 2 2 2 
2 2 2 0 2 2 2 0 2 2 2 2 8 4 8 8 8 8 7 8 4 7 8 8 8 8 8 7 8 8 4 6 8 8 7 8 8 8 1 1 2 2 2 2 2 2 2 2 0 2 
2 2 2 2 2 2 2 2 0 2 6 2 8 7 8 4 7 8 8 8 8 8 8 1 7 4 8 6 4 4 4 4 8 5 8 8 8 8 7 1 2 2 2 2 2 2 2 2 2 2 
0 2 2 2 2 2 2 2 2 2 6 4 4 4 8 1 1 6 4 4 4 4 7 1 8 8 7 8 8 8 4 4 4 4 6 8 7 0 2 2 2 2 0 2 2 2 0 2 2 2 
2 2 2 2 2 2 2 2 2 2 6 4 4 4 5 1 1 1 6 4 4 6 1 1 9 8 8 8 4 4 4 4 7 8 8 2 2 2 2 2 2 2 2 2 2 2 2 2 2 2 
2 2 2 2 2 0 2 2 2 2 6 4 4 4 1 1 1 1 1 6 4 1 1 1 1 6 0 5 6 8 7 4 9 2 2 2 2 2 2 2 2 2 2 2 0 2 2 2 2 2 
2 2 2 2 2 2 2 2 2 2 6 6 6 6 1 1 1 1 1 1 6 1 1 1 2 2 2 2 7 8 8 6 0 2 2 2 2 2 2 2 2 2 2 2 2 2 2 2 2 2 
2 2 2 0 2 2 2 2 2 2 2 2 2 2 0 2 2 2 2 2 2 2 2 2 2 2 2 2 2 2 2 2 2 2 2 2 2 2 2 0 2 2 2 2 2 2 2 2 2 2 
0 2 2 2 2 2 2 0 2 2 2 2 2 2 2 2 2 2 0 0 2 2 2 2 0 2 2 2 2 0 2 2 2 2 2 2 2 2 2 2 2 2 2 2 2 2 2 2 2 2 
2 2 2 2 2 2 2 2 2 2 0 2 2 2 2 2 2 2 2 2 2 2 2 2 2 2 0 2 2 2 2 2 2 0 2 2 0 2 2 2 2 2 2 0 2 2 2 2 2 2 
2 2 2 2 2 2 2 2 2 2 2 2 2 0 2 2 2 2 0 2 2 2 2 0 2 2 2 2 2 2 2 2 2 2 2 2 2 2 2 2 2 2 2 2 2 2 2 0 2 2 
2 2 2 2 2 0 2 2 2 2 2 2 2 2 2 2 0 2 2 2 2 2 2 2 2 2 2 2 2 2 2 2 0 2 2 2 2 2 0 2 2 2 2 2 2 2 2 2 2 2 
2 0 2 2 2 2 2 2 2 2 2 2 2 2 2 2 2 2 2 2 2 2 2 2 2 2 2 0 2 2 2 2 2 2 2 2 2 2 2 2 2 2 2 2 2 2 2 2 2 2 
2 2 2 2 2 2 2 0 2 2 2 2 2 0 2 2 2 2 0 2 2 0 2 2 2 2 2 2 2 2 0 2 2 2 2 2 2 2 2 2 2 2 2 2 2 2 2 2 2 2 
2 2 2 2 0 2 2 2 2 2 0 2 2 2 2 2 2 2 2 2 2 2 2 2 2 0 2 2 2 2 2 2 2 2 0 2 2 2 2 2 2 2 0 2 2 2 2 2 0 2 
2 2 2 2 2 2 2 2 2 2 2 2 2 2 2 2 0 2 2 2 2 2 2 2 2 2 2 2 2 2 2 2 2 2 2 2 2 2 2 2 2 2 2 2 2 2 2 2 2 2 
